16x15
0,0 1,0 2,0 1,1 0,0 1,0 2,0 1,1 0,0 1,0 2,0 1,1 0,0 1,0 2,0 1,1 
0,1 1,1 2,1 1,1 0,1 1,1 2,1 1,1 0,1 1,1 2,1 1,1 0,1 1,1 2,1 1,1 
0,2 1,2 2,2 1,1 0,2 1,2 2,2 1,1 0,2 1,2 2,2 1,1 0,2 1,2 2,2 1,1 
0,3 1,3 2,3 1,1 0,3 1,3 2,3 1,1 0,3 1,3 2,3 1,1 0,3 1,3 2,3 1,1 
0,4 1,4 2,4 1,1 0,4 1,4 2,4 1,1 0,4 1,4 2,4 1,1 0,4 1,4 2,4 1,1 
0,5 1,5 2,5 1,1 0,5 1,5 2,5 1,1 0,5 1,5 2,5 1,1 0,5 1,5 2,5 1,1 
1,1 1,1 1,1 1,1 1,1 1,1 1,1 1,1 1,1 1,1 1,1 1,1 1,1 1,1 1,1 1,1 
1,1 1,1 1,1 1,1 1,1 1,1 1,1 1,1 1,1 1,1 1,1 1,1 1,1 1,1 1,1 1,1 
1,1 1,1 1,1 1,1 1,1 1,1 1,1 1,1 1,1 1,1 1,1 1,1 1,1 1,1 1,1 1,1 
0,3 1,3 2,3 1,1 0,3 1,3 2,3 1,1 0,3 1,3 2,3 1,1 0,3 1,3 2,3 1,1 
0,4 1,4 2,4 1,1 0,4 1,4 2,4 1,1 0,4 1,4 2,4 1,1 0,4 1,4 2,4 1,1 
0,5 1,5 2,5 1,1 0,5 1,5 2,5 1,1 0,5 1,5 2,5 1,1 0,5 1,5 2,5 1,1 
0,0 1,0 2,0 1,1 0,0 1,0 2,0 1,1 0,0 1,0 2,0 1,1 0,0 1,0 2,0 1,1 
0,1 1,1 2,1 1,1 0,1 1,1 2,1 1,1 0,1 1,1 2,1 1,1 0,1 1,1 2,1 1,1 
0,2 1,2 2,2 1,1 0,2 1,2 2,2 1,1 0,2 1,2 2,2 1,1 0,2 1,2 2,2 1,1 
